[Atlas_info]
/atlas/atlas2.png
2560 1664
64 64
30 30
[ID_matrix]
0 1 1 1 1 1 1 1 1 1 1 1 1 1 1 4 4 4 4 4 4 4 4 4 4 4 4 4 4 5
40 10 13 14 13 14 13 14 13 14 13 14 13 14 13 13 14 13 14 13 14 13 14 14 13 14 13 14 15 45
40 50 290 290 290 290 290 290 290 290 290 290 290 290 290 290 290 290 290 290 290 290 290 290 290 290 290 290 135 45
40 90 290 290 17 17 17 17 17 137 269 269 17 17 17 17 17 17 269 269 17 17 137 137 137 137 290 290 95 45
40 50 290 17 17 17 17 17 137 137 269 269 17 17 17 17 17 17 269 269 17 17 137 137 137 137 137 290 135 45
40 90 290 17 132 132 17 17 17 137 269 269 17 17 17 17 17 17 269 269 17 17 137 137 132 132 137 290 95 45
40 50 290 17 132 132 17 17 17 137 269 269 17 17 17 17 17 17 269 269 17 17 137 137 132 132 137 290 135 45
40 90 290 17 17 132 17 17 17 137 269 269 17 17 17 17 17 17 269 269 17 137 137 137 137 137 137 290 95 45
40 50 290 17 17 132 17 17 17 137 269 269 17 17 17 17 17 17 269 269 17 137 137 137 17 17 17 290 55 45
40 90 290 17 17 132 132 132 132 137 269 269 17 17 132 132 17 17 269 269 17 17 17 132 132 17 17 290 175 45
40 50 290 269 269 269 269 269 269 269 269 269 269 269 269 269 269 269 269 269 269 269 269 269 269 269 269 290 55 45
40 90 290 269 269 269 269 269 269 269 269 269 269 269 269 269 269 269 269 269 269 269 269 269 269 269 269 290 175 45
40 50 290 17 17 17 17 17 17 137 269 269 0 1 2 3 4 5 269 269 17 17 17 17 17 17 17 290 55 45
40 90 290 17 17 17 17 17 17 137 269 269 40 41 42 43 44 45 269 269 17 17 17 17 17 17 17 290 175 45
40 50 290 17 17 17 17 17 17 137 269 269 80 81 82 83 84 85 269 269 17 17 17 17 17 17 17 290 55 45
120 90 290 17 17 17 17 17 17 137 269 269 120 121 122 123 124 125 269 269 17 17 17 17 17 17 17 290 175 165
120 50 290 17 17 17 17 17 17 137 269 269 160 161 162 163 164 165 269 269 17 17 17 17 17 17 17 290 55 165
120 90 290 17 17 17 17 17 17 137 269 269 200 201 202 203 204 205 269 269 17 17 17 17 132 132 17 290 175 165
120 50 290 269 269 269 269 269 269 269 269 269 269 269 269 269 269 269 269 269 269 269 269 269 269 269 269 290 55 165
120 90 290 269 269 269 269 269 269 269 269 269 269 269 269 269 269 269 269 269 269 269 269 269 269 269 269 290 175 165
120 50 290 17 17 17 17 17 17 137 269 269 17 17 17 17 17 17 269 269 17 17 17 17 17 17 17 290 55 165
120 90 290 17 17 17 17 17 17 137 269 269 17 17 17 17 17 17 269 269 17 17 17 17 17 17 17 290 175 165
120 50 290 17 17 17 17 17 17 137 269 269 17 17 17 17 17 17 269 269 17 17 17 17 17 17 17 290 55 165
120 90 290 17 17 132 132 17 17 137 269 269 17 17 17 17 17 17 269 269 17 17 17 132 132 17 17 290 175 165
160 50 290 17 17 132 132 17 17 137 269 269 17 17 132 132 17 17 269 269 17 17 17 132 132 17 17 290 55 165
160 90 290 17 17 17 17 17 17 137 269 269 17 17 17 17 17 17 269 269 17 17 17 17 17 17 17 290 175 165
160 50 290 290 17 17 17 17 17 137 269 269 17 17 17 17 17 17 269 269 17 17 17 17 17 17 290 290 55 165
160 90 290 290 290 290 290 290 290 290 290 290 290 290 290 290 290 290 290 290 290 290 290 290 290 290 290 290 175 165
160 210 211 213 214 213 214 213 214 213 214 213 214 57 58 57 58 214 213 214 213 214 213 214 213 214 213 214 215 165
200 201 201 201 201 201 201 201 201 201 201 201 201 97 98 97 98 204 204 204 204 204 204 204 204 204 204 204 204 205
